,Giorno,Ricoverati con sintomi,Terapia intensiva,Totale ospedalizzati,Isolamento domiciliare,Dimessi guariti,Deceduti,Totale casi,Tamponi,Totale positivi,Variazione totale positivi,Casi testati,Casi da sospetto diagnostico,Casi da screening,Nuovi casi,Andamento nuovi casi (MME),Decessi giornalieri,Nuovi tamponi,Perc. tamp. positivi,Percentuale nuovi casi %,Andamento perc. nuovi casi % (MME),And. nuovi tamponi (MME),Nuovi casi corretto tamponi,Nuovi casi corretto tamponi (MME),"N.c.corr. tamponi (MME, grande)",Unnamed: 25
0,2020-02-24,76,19,95,71,0,6,172,1463,166,0,0,0,0,,0,0,0,0,0,0,0,0,0,0,0.0
1,2020-02-25,79,25,104,127,0,9,240,3700,231,65,0,0,0,,68,10.2,3,2237,0.21,40.96,6.144,156.59,13.5589,2.0338,394.148
2,2020-02-26,79,25,104,145,0,9,258,3208,249,18,0,0,0,,18,11.37,0,-492,-0.0637,7.79,6.3909,111.1887,5.0546,3.1928,618.7611
3,2020-02-27,172,41,213,136,40,14,403,3320,349,100,0,0,0,,145,31.4145,5,112,9.0058,58.23,14.1668,111.2455,83.3508,18.0581,3499.5903
4,2020-02-28,235,47,282,192,40,17,531,4835,474,125,0,0,0,,128,45.9023,3,1515,8.9634,36.68,17.5438,209.5083,51.7253,18.5493,3594.7808
5,2020-02-29,256,80,336,216,40,23,615,5723,552,78,0,0,0,,84,51.617,6,888,9.0009,17.72,17.5702,257.0027,32.9705,20.26,3926.3045
6,2020-03-01,406,106,512,375,73,24,984,6879,887,335,0,0,0,,369,99.2244,1,1156,10.6039,66.85,24.9622,319.9325,177.2894,47.6733,9238.8951
7,2020-03-02,478,127,605,472,139,38,1254,7925,1077,190,0,0,0,,270,124.8408,14,1046,11.6676,30.44,25.7838,370.7573,132.2739,61.1599,11852.5557
8,2020-03-03,698,167,865,461,139,55,1520,9577,1326,249,0,0,0,,266,146.0147,17,1652,11.9779,24.7,25.6213,460.4442,150.0256,82.3532,15959.7232
9,2020-03-04,877,209,1086,411,250,73,1820,12138,1497,171,0,0,0,,300,169.1125,18,2561,11.9584,22.62,25.1711,607.4832,161.0133,90.7645,17589.8058
10,2020-03-05,1169,244,1413,364,376,98,2251,12354,1777,280,0,0,0,,431,208.3956,25,216,25.0863,28.79,25.7139,580.0793,315.1932,152.4011,29534.74
11,2020-03-06,1622,309,1931,77,469,135,2612,13556,2008,231,0,0,0,,361,231.2862,37,1202,25.4303,20.32,24.9048,623.6138,335.5974,215.0113,41668.3448
12,2020-03-07,1661,359,2020,722,524,154,3420,15778,2742,734,0,0,0,pd-IT-0002,808,317.7933,19,2222,26.1982,40.24,27.2051,735.5008,666.2303,262.0341,50781.1849
13,2020-03-08,2217,399,2616,756,550,267,4189,18534,3372,630,0,0,0,,769,385.4743,113,2756,26.3173,28.05,27.3318,876.9358,688.7175,345.2313,66904.4912
14,2020-03-09,2802,440,3242,1248,646,333,5469,20135,4490,1118,0,0,0,,1280,519.6532,66,1601,30.0751,37.96,28.9261,927.6203,1343.0667,545.2569,105668.6681
15,2020-03-10,3319,466,3785,642,896,468,5791,21479,4427,-63,0,0,0,pd-IT-0004,322,490.0052,135,1344,29.6498,7.17,25.6627,956.7668,382.4375,581.9763,112784.734
16,2020-03-11,3852,560,4412,1351,900,617,7280,25629,5763,1336,0,0,0,,1489,639.8544,149,4150,30.0873,33.63,26.8578,1180.2932,1671.0334,718.078,139160.715
17,2020-03-12,4247,605,4852,2044,1085,744,8725,29534,6896,1133,0,0,0,,1445,760.6263,127,3905,30.5712,25.07,26.5896,1371.0226,1535.2844,808.1506,156616.4386
18,2020-03-13,4435,650,5085,2647,1198,890,9820,32700,7732,836,0,0,0,,1095,810.7823,146,3166,30.8532,15.88,24.9832,1496.6711,1116.9238,827.0155,160272.397
19,2020-03-14,4898,732,5630,3429,1660,966,11685,37138,9059,1327,0,0,0,,1865,968.915,76,4438,31.6335,24.12,24.8537,1702.5641,1851.5207,961.9121,186414.8305
20,2020-03-15,5500,767,6267,3776,2011,1218,13272,40369,10043,984,0,0,0,,1587,1061.6277,252,3231,32.8562,17.52,23.7536,1809.5546,1650.098,1103.8373,213919.3757
21,2020-03-16,6171,823,6994,3867,2368,1420,14649,43565,10861,818,0,0,0,,1377,1108.9336,202,3196,33.5732,13.71,22.2471,1906.6058,1516.5037,1221.2795,236679.215
22,2020-03-17,6953,879,7832,4263,2485,1640,16220,46449,12095,1234,0,0,0,,1571,1178.2435,220,2884,35.0381,14.46,21.079,1975.0234,1870.3438,1402.7501,271847.5173
23,2020-03-18,7285,924,8209,4057,3488,1959,17713,48983,12266,171,0,0,0,,1493,1225.457,319,2534,36.7084,12.34,19.7682,2014.1517,1826.8492,1499.481,290593.5803
24,2020-03-19,7387,1006,8393,5545,3778,2168,19884,52244,13938,1672,0,0,0,,2171,1367.2884,209,3261,38.8008,17.7,19.4579,2101.4311,2603.195,1639.4834,317725.5046
25,2020-03-20,7735,1050,8785,6635,4295,2549,22264,57174,15420,1482,0,0,0,,2380,1519.1952,381,4930,39.4658,17.08,19.1013,2299.4309,2729.8775,1742.5281,337695.1617
26,2020-03-21,8258,1093,9351,8019,5050,3095,25515,66730,17370,1950,0,0,0,,3251,1778.9659,546,9556,39.0832,21.08,19.3981,2807.3908,3251,1778.9659,344756.6735
27,2020-03-22,9439,1142,10581,7304,5865,3456,27206,70598,17885,515,0,0,0,,1691,1765.771,361,3868,39.4064,9.74,17.9494,2881.6334,1864.1309,1946.5572,377235.2216
28,2020-03-23,9266,1183,10449,8461,6075,3776,28761,73242,18910,1025,0,0,0,,1555,1734.1554,320,2644,40.7639,8.69,16.5605,2864.9991,1702.6503,1898.8168,367983.3041
29,2020-03-24,9711,1194,10905,8963,6657,4178,30703,76695,19868,958,0,0,0,,1942,1765.3321,402,3453,41.8444,10.27,15.6169,2906.1591,2187.7632,1988.7377,385409.6228
30,2020-03-25,10026,1236,11262,9329,7281,4474,32346,81666,20591,723,0,0,0,,1643,1746.9823,296,4971,41.2323,8.27,14.5149,3050.698,1820.9528,1936.1973,375227.5053
31,2020-03-26,10681,1263,11944,10245,7839,4861,34889,87713,22189,1598,0,0,0,,2543,1866.3849,387,6047,41.2931,12.35,14.1901,3260.4391,2796.8223,2052.6728,397800.0007
32,2020-03-27,11137,1292,12429,11466,8001,5402,37298,95860,23895,1706,0,0,0,,2409,1947.7772,541,8147,40.4746,10.86,13.6906,3602.4984,2495.2496,2017.5136,390986.2922
33,2020-03-28,11152,1319,12471,12038,8962,5944,39415,102503,24509,614,0,0,0,,2117,1973.1606,542,6643,39.8743,8.86,12.966,3815.3335,2077.4685,1936.315,375250.3227
34,2020-03-29,11613,1328,12941,12451,9255,6360,41007,107398,25392,883,0,0,0,,1592,1915.9865,416,4895,39.3581,6.5,11.9961,3890.9102,1589.661,1913.1714,370765.1857
35,2020-03-30,11815,1330,13145,11861,10337,6818,42161,111057,25006,-386,0,0,0,,1154,1801.6885,458,3659,38.8081,4.54,10.8777,3874.6765,1175.3732,1835.0575,355627.0022
36,2020-03-31,11883,1324,13207,11917,10885,7199,43208,114640,25124,118,0,0,0,,1047,1688.4853,381,3583,38.1355,4.19,9.8745,3854.2591,1077.0969,1737.0221,336628.1347
37,2020-04-01,11927,1342,13269,12496,11415,7593,44773,121449,25765,641,0,0,0,,1565,1669.9625,394,6809,37.076,6.23,9.3279,4061.091,1535.1635,1638.1248,317462.2237
38,2020-04-02,11762,1351,13113,12763,12229,7960,46065,128286,25876,111,0,0,0,,1292,1613.2681,367,6837,35.8037,5.01,8.6802,4255.4046,1195.2769,1492.4939,289239.5088
39,2020-04-03,11802,1381,13183,13006,13020,8311,47520,135051,26189,313,0,0,0,,1455,1589.5279,351,6765,34.8024,5.62,8.2212,4431.0763,1299.6094,1419.77,275145.8987
40,2020-04-04,12002,1326,13328,13892,13242,8656,49118,141877,27220,1031,0,0,0,,1598,1590.7987,345,6826,34.0043,6.1,7.903,4598.7209,1390.4312,1384.1653,268245.8566
41,2020-04-05,12009,1317,13326,14798,13426,8905,50455,149984,28124,904,0,0,0,,1337,1552.7289,249,8107,32.779,4.91,7.454,4844.3005,1104.1929,1282.3577,248515.9334
42,2020-04-06,11914,1343,13257,15212,13863,9202,51534,154989,28469,345,0,0,0,,1079,1481.6696,297,5005,31.9964,3.84,6.9119,4855.5494,884.4497,1214.5155,235368.3712
43,2020-04-07,11833,1305,13138,15205,14498,9484,52325,159331,28343,-126,0,0,0,,791,1378.0691,282,4342,31.0307,2.78,6.2921,4819.601,647.3505,1127.8049,218564.2083
44,2020-04-08,11719,1257,12976,15569,15147,9722,53414,167557,28545,202,0,0,0,,1089,1334.7088,238,8226,29.7825,3.84,5.9243,5058.0489,838.7461,1027.9906,199220.5752
45,2020-04-09,11796,1236,13032,16042,15706,10022,54802,176953,29074,529,0,0,0,,1388,1342.7024,300,9396,28.7338,4.86,5.7647,5361.7055,1012.8436,979.7893,189879.3617
46,2020-04-10,11877,1202,13079,16451,16280,10238,56048,186325,29530,456,0,0,0,,1246,1328.1971,216,9372,27.6534,4.29,5.5435,5642.4261,867.1046,924.3065,179126.9979
47,2020-04-11,12026,1174,13200,17058,16823,10511,57592,196302,30258,728,0,0,0,,1544,1360.5675,273,9977,26.8027,5.23,5.4964,5945.8463,1029.0876,906.8285,175739.8371
48,2020-04-12,11969,1176,13145,18120,17166,10621,59052,205832,31265,1007,0,0,0,,1460,1375.4824,110,9530,25.9975,4.83,5.3965,6196.737,929.8121,875.9864,169762.7591
49,2020-04-13,12028,1143,13171,18764,17478,10901,60314,211092,31935,670,0,0,0,,1262,1358.46,280,5260,25.8576,4.04,5.193,6131.1654,813.9166,876.1277,169790.1322
50,2020-04-14,12077,1122,13199,19164,17821,11142,61326,214870,32363,428,0,0,0,,1012,1306.491,241,3778,25.9236,3.17,4.8896,5966.4439,672.1262,867.7142,168159.6398
51,2020-04-15,12043,1074,13117,19804,17855,11377,62153,221968,32921,558,0,0,0,,827,1234.5674,235,7098,24.928,2.56,4.5401,6045.6528,538.6934,804.1757,155846.1145
52,2020-04-16,11356,1032,12388,20702,18396,11608,63094,232674,33090,169,0,0,0,,941,1190.5323,231,10706,23.799,2.86,4.2881,6371.8771,549.2477,694.896,134668.1345
53,2020-04-17,10627,971,11598,21836,18850,11851,64135,243513,33434,344,0,0,0,,1041,1168.1024,243,10839,22.8051,3.15,4.1174,6684.5757,542.2565,608.4641,117917.9857
54,2020-04-18,10042,947,10989,23206,19136,12050,65381,255331,34195,761,0,0,0,,1246,1179.7871,199,11818,21.9437,3.73,4.0593,7043.9154,583.5887,552.5766,107087.1939
55,2020-04-19,10342,922,11264,23233,19526,12213,66236,264155,34497,302,183757,0,0,,855,1131.069,163,8824,21.0867,2.5,3.8254,7168.5213,403.3425,533.5768,103405.1165
56,2020-04-20,10138,901,11039,23548,20008,12376,66971,270486,34587,90,173333,0,0,dc-IT-0006,735,1071.6587,163,6331,20.4226,2.13,3.5711,7109.8948,342.609,499.5372,96808.368
57,2020-04-21,9805,851,10656,23322,21374,12579,67931,277197,33978,-609,173333,0,0,pd-IT-0012,960,1054.9099,203,6711,19.994,2.78,3.4524,7081.9722,433.6667,476.5409,92351.7674
58,2020-04-22,9692,817,10509,23733,22110,12740,69092,290699,34242,264,184323,0,0,,1161,1070.8234,161,13502,19.1964,3.42,3.4476,7531.3741,486.3671,448.5902,86935.0444
59,2020-04-23,9192,790,9982,23891,23352,12940,70165,302715,33873,-369,190451,0,0,,1073,1071.1499,200,12016,18.4757,3.13,3.3999,7845.2979,409.8762,409.1694,79295.4431
60,2020-04-24,8791,756,9547,24821,23782,13106,71256,314298,34368,495,196406,0,0,,1091,1074.1274,166,11583,17.8404,3.22,3.3729,8106.9371,385.7267,379.7613,73596.2656
61,2020-04-25,8489,724,9213,25260,24227,13269,71969,326940,34473,105,202827,0,0,,713,1019.9583,163,12642,16.9836,2.07,3.1775,8424.3915,234.0976,334.8804,64898.5219
62,2020-04-26,8481,706,9187,25979,24398,13325,72889,337797,35166,693,208471,0,0,,920,1004.9645,56,10857,16.3897,2.67,3.1014,8594.6741,295.2412,322.5075,62500.7039
63,2020-04-27,7525,680,8205,27236,24589,13449,73479,342850,35441,275,211523,0,0,,590,942.7199,124,5053,16.0614,1.68,2.8882,8346.7569,174.1236,278.22,53917.9465
64,2020-04-28,7280,655,7935,27809,25029,13575,74348,351423,35744,303,216526,0,0,,869,931.6619,126,8573,15.6441,2.45,2.8224,8362.5939,247.5543,265.405,51434.4519
65,2020-04-29,7120,634,7754,28368,25333,13679,75134,365895,36122,378,223952,0,0,,786,909.8126,104,14472,14.927,2.2,2.7291,8790.2523,208.1574,240.9468,46694.5578
66,2020-04-30,6834,605,7439,28772,25749,13772,75732,376943,36211,89,229880,0,0,,598,863.0407,93,11048,14.2601,1.66,2.5687,8948.2947,149.252,215.4023,41744.1314
67,2020-05-01,6628,563,7191,29282,26136,13860,76469,390644,36473,262,236822,0,0,,737,844.1346,88,13701,13.6399,2.04,2.4894,9280.9841,171.4382,196.3594,38053.6949
68,2020-05-02,6529,545,7074,29593,26146,14189,77002,403702,36667,194,243383,0,0,dc-IT-0016,533,797.4644,329,13058,12.9721,1.46,2.335,9545.3752,118.5889,177.4305,34385.3327
69,2020-05-03,6609,532,7141,29785,26371,14231,77528,410857,36926,259,247176,0,0,,526,756.7447,42,7155,12.5821,1.43,2.1992,9378.0489,120.2478,172.9979,33526.3152
70,2020-05-04,6414,532,6946,30361,26504,14294,78105,418835,37307,381,251661,0,0,,577,729.783,63,7978,12.2053,1.56,2.1034,9280.0455,129.6598,163.9922,31781.0547
71,2020-05-05,6201,509,6710,30382,27124,14389,78605,425290,37092,-215,255292,0,0,,500,695.3156,95,6455,11.89,1.34,1.9889,9082.2923,110.9026,154.2247,29888.139
72,2020-05-06,6079,480,6559,25194,33005,14611,79369,439806,31753,-5339,262964,0,0,dc-IT-0020,764,705.6182,222,14516,11.4287,2.06,1.9995,9462.6518,158.9875,146.8383,28456.6936
73,2020-05-07,5848,480,6328,25687,33329,14745,80089,455294,32015,262,262964,0,0,,720,707.7755,134,15488,10.9507,2.27,2.0401,9884.4262,138.3861,136.0365,26363.3384
74,2020-05-08,5702,400,6102,25881,33901,14839,80723,466287,31983,-32,277106,0,0,,634,696.7092,94,10993,10.5901,1.98,2.0311,9962.0264,116.5893,128.1212,24829.3824
75,2020-05-09,5535,330,5865,24397,36039,14924,81225,477765,30262,-1721,282817,0,0,,502,667.5028,85,11478,10.1568,1.57,1.9619,10068.1445,87.7945,116.7391,22623.5908
76,2020-05-10,5428,348,5776,24414,36331,14986,81507,485134,30190,-72,287330,0,0,,282,609.6774,62,7369,9.7118,0.93,1.8071,9879.2044,49.4993,107.0163,20739.3512
77,2020-05-11,5397,341,5738,24673,36406,15054,81871,492642,30411,221,292603,0,0,,364,572.8258,68,7508,9.368,1.21,1.7176,9713.2201,64.557,101.5932,19688.3687
78,2020-05-12,5222,322,5544,25131,37113,15116,82904,513244,30675,264,305152,0,0,dc-IT-0026,1033,641.8519,62,20602,9.0622,3.4,1.9699,10475.4347,164.1331,101.9837,19764.0468
79,2020-05-13,5007,307,5314,24718,38081,15185,83298,524163,30032,-643,310896,0,0,,394,604.6741,69,10919,8.6799,1.28,1.8664,10506.4843,59.8281,91.8185,17794.0738
80,2020-05-14,4818,297,5115,24841,38568,15296,83820,538243,29956,-76,318289,0,0,,522,592.273,111,14080,8.3313,1.74,1.8475,10756.6304,74.522,84.5544,16386.3112
81,2020-05-15,4705,276,4981,22765,40962,15411,84119,550405,27746,-2210,325071,0,0,,299,548.2821,115,12162,7.9231,1,1.7204,10855.0062,41.191,75.5328,14637.9535
82,2020-05-16,4521,268,4789,22890,41389,15450,84518,564550,27679,-67,333243,0,0,,399,525.8897,39,14145,7.5645,1.44,1.6783,11085.3058,51.7505,68.2082,13218.4864
83,2020-05-17,4480,255,4735,22695,41895,15519,84844,576359,27430,-249,340164,0,0,,326,495.9063,69,11809,7.231,1.18,1.6036,11135.9644,41.6154,63.3048,12268.2221
84,2020-05-18,4482,252,4734,22339,42403,15543,85019,581437,27073,-357,343213,0,0,,175,447.7703,24,5078,6.9628,0.64,1.459,10711.9069,23.219,59.4103,11513.4812
85,2020-05-19,4426,244,4670,22621,42593,15597,85481,596355,27291,218,353579,0,0,,462,449.9048,54,14918,6.6924,1.71,1.4967,11006.3334,58.852,57.3112,11106.6913
86,2020-05-20,4281,231,4512,22159,43442,15662,85775,607863,26671,-620,359922,0,0,,294,426.5191,65,11508,6.4059,1.08,1.4342,11041.4501,36.0691,52.327,10140.7786
87,2020-05-21,4119,226,4345,22370,43649,15727,86091,622565,26715,44,368046,0,0,,316,409.9412,65,14702,6.1045,1.18,1.396,11297.6886,36.4865,47.3333,9173.005
88,2020-05-22,4028,207,4235,21698,44667,15784,86384,641593,25933,-782,378934,0,0,,293,392.4,57,19028,5.7822,1.1,1.3516,11838.8104,31.4672,42.1424,8167.0318
89,2020-05-23,4026,199,4225,21405,45355,15840,86825,658784,25630,-303,389648,0,0,,441,399.69,56,17191,5.5595,1.7,1.4039,12213.4636,45.8006,41.5103,8044.5369
90,2020-05-24,4017,197,4214,21400,45656,15840,87110,670241,25614,-16,396992,0,0,pd-IT-0020,285,382.4865,0,11457,5.3453,1.11,1.3598,12160.5112,29.6505,39.7927,7711.6747
91,2020-05-25,3721,196,3917,21298,46169,15874,87258,675882,25215,-399,400252,0,0,,148,347.3135,34,5641,5.1531,0.58,1.2428,11704.1454,14.8703,34.8964,6762.7829
92,2020-05-26,3622,183,3805,20672,47044,15896,87417,685058,24477,-738,405650,0,0,,159,319.0665,22,9176,4.9114,0.63,1.1509,11527.1752,15.757,31.6197,6127.7757
93,2020-05-27,3626,175,3801,20236,47810,15954,87801,697561,24037,-440,413483,0,0,,384,328.8065,58,12503,4.7846,1.57,1.2138,11595.483,37.7907,32.3589,6271.0366
94,2020-05-28,3470,173,3643,19270,49296,15974,88183,713068,22913,-1124,422568,0,0,,382,336.7856,20,15507,4.6247,1.59,1.2702,11869.2892,35.2,31.0336,6014.1989
95,2020-05-29,3552,173,3725,18958,49842,16012,88537,727146,22683,-230,430863,0,0,,354,339.3677,38,14078,4.476,1.54,1.3107,12023.8989,32.9252,31.5643,6117.0406
96,2020-05-30,3307,172,3479,18330,50870,16079,88758,741447,21809,-874,438415,0,0,,221,321.6126,67,14301,4.2676,0.97,1.2596,12183.296,18.9464,27.5719,5343.3363
97,2020-05-31,3131,170,3301,17695,51860,16112,88968,753874,20996,-813,445930,0,0,,210,304.8707,33,12427,4.0879,0.96,1.2146,12200.3553,17.0584,24.7647,4799.3074
98,2020-06-01,3085,167,3252,17609,52026,16131,89018,757446,20861,-135,447874,0,0,,50,266.6401,19,3572,3.8997,0.24,1.0684,11596.3704,4.2096,22.4491,4350.5459
99,2020-06-02,3021,166,3187,17068,52807,16143,89205,766122,20255,-606,451502,0,0,,187,254.6941,12,8676,3.7808,0.9,1.0432,11391.9445,15.7062,21.3918,4145.6525
100,2020-06-03,2995,131,3126,17098,53046,16172,89442,777477,20224,-31,458782,0,0,,237,252.04,29,11355,3.6631,1.17,1.0622,11389.3584,19.5291,20.7684,4024.8433
101,2020-06-04,2954,125,3079,17145,53101,16201,89526,780887,20224,0,460658,0,0,,84,226.834,29,3410,3.5817,0.42,0.9659,10830.8033,7.1692,19.3598,3751.863
102,2020-06-05,2960,120,3080,16773,53853,16222,89928,800276,19853,-371,475041,0,0,,402,253.1089,21,19389,3.478,1.99,1.1195,11429.877,32.5222,20.4768,3968.3173
103,2020-06-06,2840,110,2950,16549,54322,16249,90070,813972,19499,-354,480566,0,0,,142,236.4425,27,13696,3.3045,0.72,1.0596,11588.5057,10.8524,18.0703,3501.9509
104,2020-06-07,2801,107,2908,16512,54505,16270,90195,821977,19420,-79,485842,0,0,,125,219.7262,21,8005,3.1852,0.64,0.9966,11337.6603,9.6256,16.9199,3279.0089
105,2020-06-08,2708,107,2815,16504,54768,16302,90389,826465,19319,-101,489775,0,0,,194,215.8672,32,4488,3.2632,1,0.9971,10858.184,15.0997,16.8017,3256.1004
106,2020-06-09,2660,96,2756,15541,55967,16317,90581,836313,18297,-1022,496273,0,0,,192,212.2871,15,9848,3.1678,0.99,0.9961,10787.4712,14.7267,16.2828,3155.5359999999996
107,2020-06-10,2565,98,2663,15194,56474,16349,90680,845618,17857,-440,502047,0,0,,99,195.2941,32,9305,3.0231,0.54,0.9277,10683.6982,7.4085,14.6145,2832.2298
108,2020-06-11,2488,97,2585,14755,57218,16374,90932,858994,17340,-517,509853,0,0,,252,203.8,25,13376,2.9445,1.41,1,10872.1593,17.9883,14.5477,2819.2833
109,2020-06-12,2357,97,2454,14570,57775,16405,91204,873831,17024,-316,519095,0,0,,272,214.03,31,14837,2.8643,1.57,1.0855,11149.6982,17.9732,14.1427,2740.7909
110,2020-06-13,2252,96,2348,14437,58201,16428,91414,883305,16785,-239,524774,0,0,,210,213.4255,23,9474,2.8178,1.23,1.1072,11032.3993,13.4181,13.637,2642.7997
111,2020-06-14,2116,94,2210,13779,59220,16449,91658,892641,15989,-796,530683,0,0,,244,218.0117,21,9336,2.8026,1.45,1.1586,10913.6513,14.834,13.254,2568.5722
112,2020-06-15,2018,94,2112,13864,59484,16457,91917,899278,15976,-13,534981,0,0,,259,224.1599,8,6637,2.8794,1.62,1.2278,10614.2857,15.472,13.3908,2595.0811
113,2020-06-16,1902,69,1971,13262,60361,16466,92060,906322,15233,-743,539604,0,0,,143,211.9859,9,7044,2.8178,0.9,1.1786,10364.3657,8.1644,12.1031,2345.5288
114,2020-06-17,1796,59,1855,13117,60850,16480,92302,917881,14972,-261,547133,0,0,,242,216.488,14,11559,2.7676,1.59,1.2403,10447.9901,12.8995,11.5396,2236.325
115,2020-06-18,1673,60,1733,12914,61355,16516,92518,929356,14647,-325,554148,0,0,,216,216.4148,36,11475,2.7069,1.44,1.2703,10519.8808,10.6828,10.7033,2074.2668
116,2020-06-19,1537,60,1597,12448,62096,16534,92675,939820,14045,-602,560376,0,0,,157,207.5026,18,10464,2.6224,1.07,1.2402,10515.9692,7.1581,9.4607,1833.4498
117,2020-06-20,1401,54,1455,12456,62372,16557,92840,949134,13911,-134,565933,0,0,,165,201.1272,23,9314,2.5648,1.17,1.2297,10431.8313,6.9093,8.4221,1632.1615
118,2020-06-21,1260,53,1313,12530,62555,16570,92968,956959,13843,-68,570750,0,0,,128,190.1581,13,7825,2.4973,0.92,1.1833,10249.3531,4.9229,7.3135,1417.3367
119,2020-06-22,1047,51,1098,12540,62900,16573,93111,964735,13638,-205,575981,0,0,,143,183.0844,3,7776,2.4485,1.03,1.1603,10076.2184,4.6783,5.9896,1160.7695
120,2020-06-23,910,51,961,11942,63691,16579,93173,971721,12903,-735,580317,0,0,,62,164.9217,6,6986,2.3401,0.45,1.0537,9859.9031,1.8142,4.8258,935.2302
121,2020-06-24,692,48,740,11487,64448,16586,93261,980820,12227,-676,586567,0,0,,88,153.3835,7,9099,2.2463,0.68,0.9977,9806.6399,1.9936,3.4748,673.4106
122,2020-06-25,622,48,670,11322,64831,16608,93431,990652,11992,-235,592797,88676,4755,,170,155.876,22,9832,2.208,1.39,1.0565,9808.4151,3.4863,3.1967,619.5052
123,2020-06-26,501,47,548,11092,65323,16624,93587,1004753,11640,-352,600985,88720,4867,,156,155.8946,16,14101,2.1305,1.3,1.093,10108.8961,2.5389,2.5372,491.6971
124,2020-06-27,415,43,458,10534,66046,16626,93664,1014321,10992,-648,606607,88764,4900,,77,144.0604,2,9568,2.0373,0.66,1.0281,10071.0333,1.0513,1.9669,381.1763
125,2020-06-28,323,43,366,10581,66175,16639,93761,1022440,10947,-45,611487,88812,4949,,97,137.0013,13,8119,1.9787,0.88,1.0059,9934.391,1.0729,1.5153,293.6665
126,2020-06-29,321,43,364,10459,66376,16640,93839,1030431,10823,-124,615813,88821,5018,,78,128.1511,1,7991,1.9102,0.71,0.9615,9798.3536,0.8699,1.4293,276.9878
127,2020-06-30,297,42,339,9721,67197,16644,93901,1036548,10060,-763,619851,88687,5214,,62,118.2285,4,6117,1.8465,0.57,0.9028,9540.6589,0.6614,1.2612,244.418
128,2020-07-01,277,41,318,9620,67422,16650,94010,1044975,9938,-122,625197,88747,5263,,109,116.8442,6,8427,1.8082,1.08,0.9294,9462.7028,1.0997,1.1789,228.4593
129,2020-07-02,241,41,282,9545,67610,16671,94108,1054415,9827,-111,630993,88793,5315,,98,114.0176,21,9440,1.7517,0.99,0.9384,9461.1136,0.877,1.0203,197.7281
130,2020-07-03,241,41,282,9395,67871,16675,94223,1064173,9677,-150,636860,88834,5389,,115,114.1649,4,9758,1.7131,1.17,0.9732,9481.8956,1.0268,1.0194,197.5498
131,2020-07-04,231,36,267,9159,68201,16691,94318,1074333,9426,-251,642762,88857,5461,,95,111.2902,16,10160,1.6561,0.98,0.9742,9529.3629,0.7991,0.9362,181.4237
132,2020-07-05,230,36,266,9179,68274,16697,94416,1083105,9445,19,647739,88891,5525,,98,109.2967,6,8772,1.6172,1.04,0.9841,9476.3475,0.8259,0.9211,178.4997
133,2020-07-06,233,36,269,9223,68335,16700,94527,1088960,9492,47,651688,88967,5560,,111,109.5522,3,5855,1.637,1.18,1.0135,9222.8532,0.972,0.9593,185.9079
134,2020-07-07,229,36,265,8809,68793,16713,94580,1092340,9074,-418,653837,88988,5592,,53,101.0693,13,3380,1.6344,0.56,0.9454,8813.8535,0.4784,0.9123,176.8029
135,2020-07-08,211,34,245,8215,69466,16725,94651,1103015,8460,-614,660133,89010,5641,,71,96.5589,12,10675,1.569,0.78,0.9206,8944.1337,0.5839,0.7941,153.8899
136,2020-07-09,201,31,232,8125,69683,16730,94770,1114827,8357,-103,667911,89057,5713,,119,99.9251,5,11812,1.5292,1.41,0.994,9144.8844,0.9064,0.7611,147.494
137,2020-07-10,190,27,217,8124,69828,16736,94905,1126332,8341,-16,675013,89120,5785,,135,105.1863,6,11505,1.5061,1.62,1.0879,9310.0925,0.9447,0.7361,142.6445
138,2020-07-11,173,29,202,8010,70020,16740,94972,1133387,8212,-129,679427,89131,5841,,67,99.4584,4,7055,1.4637,0.8,1.0447,9152.236,0.444,0.659,127.719
139,2020-07-12,160,31,191,7813,70297,16748,95049,1142932,8004,-208,685763,89163,5886,,77,96.0896,8,9545,1.4172,0.94,1.029,9179.7295,0.481,0.6002,116.3241
140,2020-07-13,168,30,198,7813,70375,16757,95143,1149414,8011,7,689917,89209,5934,,94,95.7762,9,6482,1.423,1.17,1.0502,8990.8884,0.6215,0.6332,122.7185
141,2020-07-14,176,27,203,7749,70461,16760,95173,1155050,7952,-59,693556,89200,5973,,30,85.9098,3,5636,1.3584,0.37,0.9481,8756.0462,0.2088,0.598,115.8832
142,2020-07-15,177,23,200,7335,70936,16765,95236,1165476,7535,-417,699935,89240,5996,,63,82.4733,5,10426,1.3053,0.79,0.9244,8872.943,0.4263,0.5581,108.1597
143,2020-07-16,164,23,187,7322,71032,16775,95316,1176203,7509,-26,706440,89270,6046,,80,82.1023,10,10727,1.263,1.06,0.9448,9002.727,0.4989,0.512,99.2231
144,2020-07-17,159,22,181,7240,71172,16778,95371,1186114,7421,-88,712261,89280,6091,,55,78.037,3,9911,1.2166,0.73,0.9125,9066.3061,0.3297,0.4677,90.6439
145,2020-07-18,149,22,171,7084,71416,16788,95459,1195168,7255,-166,717516,89332,6127,,88,79.5314,10,9054,1.2014,1.19,0.9542,9065.4447,0.4984,0.4504,87.2842
146,2020-07-19,148,22,170,7070,71464,16788,95492,1202207,7240,-15,721640,89336,6156,,33,72.5517,0,7039,1.1523,0.45,0.8785,8923.5935,0.1887,0.415,80.4168
147,2020-07-20,151,21,172,6969,71611,16796,95548,1206495,7141,-99,724365,89367,6181,,56,70.0689,8,4288,1.1626,0.77,0.8623,8599.102,0.3363,0.4208,81.5438
148,2020-07-21,151,21,172,6838,71775,16797,95582,1212468,7010,-131,728169,89382,6200,,34,64.6586,1,5973,1.1233,0.48,0.8049,8415.2748,0.2086,0.3968,76.8911
149,2020-07-22,149,17,166,6809,71860,16798,95633,1217829,6975,-35,733150,89400,6233,,51,62.6098,1,5361,1.1146,0.73,0.7937,8201.4756,0.3099,0.3805,73.7307
150,2020-07-23,139,17,156,6785,71973,16801,95715,1232915,6941,-34,740405,89426,6289,,82,65.5183,3,15086,1.0716,1.18,0.8516,8683.3923,0.4423,0.3534,68.4838
151,2020-07-24,144,17,161,6598,72208,16801,95768,1242775,6759,-182,746025,89450,6318,,53,63.6406,0,9860,1.0316,0.76,0.8379,8765.7549,0.2923,0.3509,68.0081
152,2020-07-25,148,13,161,6614,72271,16801,95847,1253500,6775,16,752200,89482,6365,,79,65.9445,0,10725,1.0084,1.17,0.8877,8902.902,0.4289,0.358,69.3845
153,2020-07-26,139,13,152,6619,72349,16801,95921,1261557,6771,-4,756888,89521,6400,,74,67.1528,0,8057,1.0008,1.09,0.918,8843.6889,0.3818,0.3465,67.1528
154,2020-07-27,137,14,151,6574,72429,16801,95955,1265549,6725,-46,759439,89531,6424,,34,62.1799,0,3992,0.9937,0.5,0.8553,8504.0707,0.1812,0.3315,64.2377
155,2020-07-28,151,13,164,6514,72528,16802,96008,1271875,6678,-47,763406,89560,6448,,53,60.8029,1,6326,0.9802,0.79,0.8455,8351.6057,0.3125,0.3585,69.4685
156,2020-07-29,154,13,167,6396,72689,16802,96054,1280533,6563,-115,768509,89567,6487,,46,58.5825,0,8658,0.9466,0.69,0.8222,8373.0533,0.2754,0.3508,67.9814
157,2020-07-30,151,13,164,5871,73305,16802,96142,1291740,6035,-528,775765,89655,6487,,88,62.9951,0,11207,0.9363,1.34,0.8999,8571.4296,0.5055,0.3619,70.1273
158,2020-07-31,148,7,155,5856,73402,16806,96219,1300088,6011,-24,782147,89624,6595,,77,65.0958,4,8348,0.9338,1.28,0.9569,8555.7895,0.4188,0.3541,68.6143
159,2020-08-01,158,9,167,5788,73512,16807,96274,1308507,5955,-56,787173,89651,6623,,55,63.5815,1,8419,0.9174,0.91,0.9499,8546.2142,0.3227,0.373,72.2875
160,2020-08-02,153,9,162,5659,73676,16815,96312,1316219,5821,-134,791698,89676,6636,,38,59.7442,8,7712,0.8882,0.64,0.9034,8487.8192,0.2177,0.3423,66.3445
161,2020-08-03,162,9,171,5624,73724,16818,96337,1320427,5795,-26,794279,89689,6648,,25,54.5326,3,4208,0.868,0.43,0.8324,8188.2319,0.1567,0.3419,66.2601
162,2020-08-04,160,9,169,5583,73810,16819,96381,1326123,5752,-43,797918,89704,6677,,44,52.9527,1,5696,0.8632,0.76,0.8215,8013.7757,0.2786,0.3353,64.9722
163,2020-08-05,164,11,175,5648,73872,16824,96519,1335383,5823,71,803355,89814,6705,,138,65.7098,5,9260,0.9078,2.4,1.0583,8101.0114,0.895,0.4262,82.5884
164,2020-08-06,168,11,179,5549,74080,16829,96637,1344362,5728,-95,808787,89887,6750,,118,73.5533,5,8979,0.9353,2.03,1.204,8162.4706,0.7769,0.4843,93.8477
165,2020-08-07,170,9,179,5466,74232,16829,96706,1352490,5645,-83,813260,89924,6782,,69,72.8703,0,8128,0.9258,1.2,1.2034,8160.0576,0.4544,0.4799,93.0037
166,Giorno,Ricoverati con sintomi,Terapia intensiva,Totale ospedalizzati,Isolamento domiciliare,Dimessi guariti,Deceduti,Totale casi,Tamponi,Totale positivi,Variazione totale positivi,Casi testati,Casi da sospetto diagnostico,Casi da screening,Nuovi casi,Andamento nuovi casi (MME),Decessi giornalieri,Nuovi tamponi,Perc. tamp. positivi,Percentuale nuovi casi %,Andamento perc. nuovi casi % (MME),And. nuovi tamponi (MME),Nuovi casi corretto tamponi,Nuovi casi corretto tamponi (MME),"N.c.corr. tamponi (MME, grande)",
